⬛⬛⬛⬛⬛⬛⬛⬛⬛⬛⬛
⬛🟥⬜⬜⬜⬜⬛⬜⬜⬜⬛
⬛⬛⬛⬛⬛⬜⬛⬛⬛⬜⬛
⬛⬜⬜⬜⬛⬜⬛⬜⬜⬜⬛
⬛⬜⬛⬜⬛⬜⬛⬜⬛⬜⬛
⬛⬜⬛⬜⬛⬜⬛⬜⬛⬜⬛
⬛⬛⬛⬜⬛⬜⬛⬜⬛⬜⬛
⬛⬜⬜⬜⬛⬜⬛⬜⬛⬜⬛
⬛⬜⬛⬛⬛⬜⬛⬜⬛⬜⬛
⬛⬜⬜⬜⬜⬜⬜⬜⬛🟩⬛
⬛⬛⬛⬛⬛⬛⬛⬛⬛⬛⬛

Maze Seed: 92517
Maze Size: 11x11
