⬛⬛⬛⬛⬛⬛⬛⬛⬛⬛⬛
⬛🟥⬛⬜⬜⬜⬛⬜⬜⬜⬛
⬛⬜⬛⬜⬛⬜⬛⬜⬛⬛⬛
⬛⬜⬛⬜⬛⬜⬛⬜⬜⬜⬛
⬛⬜⬛⬜⬛⬜⬛⬛⬛⬜⬛
⬛⬜⬜⬜⬛⬜⬜⬜⬜⬜⬛
⬛⬛⬛⬛⬛⬛⬛⬛⬛⬜⬛
⬛⬜⬜⬜⬜⬜⬛⬜⬜⬜⬛
⬛⬜⬛⬜⬛⬛⬛⬜⬛⬛⬛
⬛⬜⬛⬜⬜⬜⬜⬜⬜🟩⬛
⬛⬛⬛⬛⬛⬛⬛⬛⬛⬛⬛

Maze Seed: 990126
Maze Size: 11x11