⬛⬛⬛⬛⬛⬛⬛⬛⬛⬛⬛
⬛🟥⬛⬜⬜⬜⬜⬜⬜⬜⬛
⬛⬜⬛⬜⬛⬛⬛⬛⬛⬜⬛
⬛⬜⬛⬜⬛⬜⬜⬜⬜⬜⬛
⬛⬜⬛⬛⬛⬜⬛⬛⬛⬜⬛
⬛⬜⬜⬜⬛⬜⬜⬜⬛⬜⬛
⬛⬛⬛⬜⬛⬜⬛⬜⬛⬜⬛
⬛⬜⬜⬜⬛⬜⬛⬜⬛⬜⬛
⬛⬜⬛⬛⬛⬛⬛⬜⬛⬜⬛
⬛⬜⬜⬜⬜⬜⬜⬜⬛🟩⬛
⬛⬛⬛⬛⬛⬛⬛⬛⬛⬛⬛

Maze Seed: 493789
Maze Size: 11x11
